NO ./textures/north_wall.xpm
SO ./textures/south_wall.xpm
WE ./textures/west_wall.xpm
EA ./textures/east_wall.xpm

F 220,100,0
C 225,30,0




1111111111111111111111111111111111
1000000000000000000000000000000001
1000000000000000000000000000000001
1001111111111110001111111111111001
1001          10001           1001
1001          10001           1001
1001          10001           1001
1001          10001           1001
1001          10001           1001
1001111111111110001111111111111001
1000000000000000000000000000000001
1000000000000000S00000000000000001
1000000000000000000000000000000001
1001111111111110001111111111111001
1001          10001           1001
1001          10001           1001
1001          10001           1001
1001          10001           1001
1001          10001           1001
1001          10001           1001
1001111111111110001111111111111001
1000000000000000000000000000000001
1000000000000000000000000000000001
1111111111111111111111111111111111