NO ./textures/blue_city2.png
SO ./textures/blue_city1.png
WE ./textures/colorstone.png
EA ./textures/mossy.png

F 8, 36, 90
C 64, 146, 174




1111111111111111111111111111111111
1000000000000000000000000000000001
1000000000000000000000000000000001
1001111111111110001111111111111001
1001          10001           1001
1001          10001           1001
1001          10001           1001
1001          10001           1001
1001          10001           1001
1001111111111110S01111111111111001
1000000000000000000000000000000001
1000000000000000000000000000000001
1000000000000000001000000000000001
1001111111111110001111111111111001
1001          10001           1001
1001          10001           1001
1001          10001           1001
1001          10001           1001
1001          10001           1001
1001          10001           1001
1001111111111110001111111111111001
1000000000000000000000000000000001
1000000000000000000000000000000001
1111111111111111111111111111111111