NO ./textures/north_wall.xpm
SO ./textures/south_wall.xpm
WE ./textures/west_wall.xpm
EA ./textures/east_wall.xpm

F 220,100,0
C 225,30,0




111111111111111111111111111111111111111111111
1001                10001                1001
1001                10001                1001
1001                10001                1001
1001                10001                1001
1001                10001                1001
111111111111111111111000111111111111111111001
100000000000000000000000000000000000000000001
1000000000000000000000S0000000000000000000001
100000000000000000000000000000000000000000001
111111111111111111111000111111111111111111111
1001                10001                1001
1001                10001                1001
1001                10001                1001
1001                10001                1001
1001                10001                1001
1001                10001                1001
111111111111111111111111111111111111111111111