NO ./textures/north_texture.png
SO ./textures/south_texture.png
WE ./textures/west_texture.png
EA ./textures/east_texture.png



F 50, 150, 20
C 10, 54, 55

1111111111111111
1100000000000001
1000000000000001
1000000000000001
1000000000000001
1111111101000001
10000000N1000001
1000000001000001
1000000001000001
1000000001000001
1000000000000001
1000000000000001
1111111111111111
