NO ./textures/mossy.png
SO ./textures/greystone.png
WE ./textures/redbrick.png
EA ./textures/hola.png


F 0, 0, 0
C 100, 100, 100

1111111
10000011111111
100000000000001111111111111111111
100000000000000000000001111111111111111111
1000000000000000000000000000011111111
100000000000E00000000000000000000000111
10000000000000000000000000000011111111
10000000000000000001111111111111111111
100000000001111111111111111111
111111111111
