NO ./textures/bluestone.png
SO ./textures/greystone.png
WE ./textures/redbrick.png
EA ./textures/hola.png


F 220,100,0
C 225,30,0

1111111
10000011111111
100000000000001111111111111111111
100000000000000000000001111111111111111111
1000000000000000000000000000011111111
100000000000000000000000000000000000W111
10000000000000000000000000000011111111
10000000000000000001111111111111111111
100000000001111111111111111111
111111111111
