NO ./textures/grass_3.png
SO ./textures/cobblestone_1.png
WE ./textures/wood.png
EA ./textures/mossy.png

F 19, 64, 65
C 43, 158, 160


1111111
10000011111111
100000000000001111111111111111111
100000000000000000000001111111111111111111
1000000000000000000000000000011111111
1000000000000000000000000000000000W111
10000000000000000000000000000011111111
10000000000000000001111111111111111111
100000000001111111111111111111
111111111111
