NO ./textures/north_wall.xpm
SO ./textures/south_wall.xpm
WE ./textures/west_wall.xpm
EA ./textures/east_wall.xpm

F 220,100,0
C 225,30,0

1111111
10000011111111
100000000000001111111111111111111
100000000000000000000001111111111111111111
10000000000000000000000000000000001111
10000000000000000000000000000000000W111
1000000000000000000000000000000001111
10000000000000000001111111111111111111
100000000001111111111111111111
111111111111