NO ./textures/north_wall.xpm
SO ./textures/south_wall.xpm
WE ./textures/west_wall.xpm
EA ./textures/east_wall.xpm

F 220,100,0
C 225,30,0

        1111111111111111111111111
        1000000000110000000000001
        1011000001110000000000001
        1001000000000000000000001
111111111011000001110000000000001
100000000011000001110111111111111
1111011111111101110000001000101
111101111111110111010100100011111
11N000001101010111111111111110001
100000000000000011         10001
100000000000000011         10001
100000000000000011         11111
1111111111111111111111111111
1111111111111111111111111111